1111111111111
1PC0000000001
1000000111111
1000000001111
10000011E1111
1111111111111