11111111111111111111111111111
100000000000000000000000000E1
10000000000000000000000000001
10000000000000000000000000001
10000000000000000000000000001
10000000000000000000000000001
10000000000000000000000000001
10000000000000000000000000001
10000000000000000000000000001
1000000C00000000000C000000001
10000000000000000000000000001
10000000000000C00000000000001
10000000000000000000000000001
1000000000000P0000000000000C1
11111111111111111111111111111