1111111111111111111111111111111111111111
100000E000000000000000000000000000000001
100000000000000000000000000000C000000001
10C0000000000000000000000000000000000001
100000000000000000000000000000C000000001
10C0000000000000000000000000000000000001
100000000000000000000000000000C000000001
10C0000000000000000000000000000000000001
100000000000000000C000000000000000000001
10C0000000000000000000000000000000000001
100000000000000000C000000000000000000001
10C0000000000000000000000000000000000001
100000000000000000C000000000000000000001
10C0000000000000000000000000000000000001
100000000000000000C000000000000000000001
10C0000000000000000000000000000000000001
100000000000000000C000000000000000000001
10C0000000000000000000000000000000000001
1000000000000P00000000000000000000000001
100011110C011110000000000000000000000001
100C00001010000C000000000000000000000001
1111111111111111111111111111111111111111