111111111111111111111
100000E00000000000001
100000000000000000001
100000000000000000001
100000000000000000001
100011110001111000001
100000001010000000001
111111111111111111111
